1 1 1 4 2 1 1 1 1 1 1 1 1 1 1 2 4 1 1 1 1 1 1 1 1 1 1 1 1 1 1
1 1 1 4 2 1 1 1 1 1 1 1 1 1 1 2 4 1 1 1 1 1 1 1 1 1 1 1 1 1 1
1 1 1 4 2 1 1 1 1 1 1 7 1 1 1 2 4 1 1 1 1 1 1 1 1 1 1 5 1 1 1
1 1 1 4 2 1 1 1 1 1 1 1 1 1 1 2 4 1 5 1 1 1 1 1 1 1 1 1 1 1 1
1 1 1 4 2 1 1 1 1 1 1 1 1 1 1 2 4 1 1 1 1 1 1 1 1 1 1 1 1 1 1
1 1 1 4 2 1 1 1 1 1 1 1 1 1 1 2 4 1 1 1 1 1 1 1 1 1 1 1 1 1 1
1 1 1 4 2 1 1 1 1 1 1 1 1 1 1 2 4 1 1 1 1 1 1 1 1 1 1 1 1 1 1
1 1 1 4 2 1 1 1 1 1 1 1 1 1 1 2 4 1 1 1 1 1 5 1 1 1 1 1 1 1 1
1 1 1 4 2 2 2 2 2 3 3 2 2 2 2 2 4 1 1 1 1 1 1 1 1 1 1 1 1 1 1
1 1 1 4 4 4 4 4 4 6 6 4 4 4 4 4 4 1 1 1 1 1 1 1 1 1 1 1 1 5 1
1 5 1 1 1 1 1 1 1 6 6 1 1 1 1 1 1 1 1 1 1 1 1 1 1 1 1 1 1 1 1
1 1 1 1 1 1 1 1 1 6 6 1 1 1 1 1 1 1 1 1 1 1 1 1 1 5 1 1 1 1 1
1 1 1 1 1 1 1 1 1 6 6 1 1 1 1 1 1 1 1 1 1 1 1 1 1 1 1 1 1 1 1
1 1 1 1 1 1 1 1 1 6 1 1 1 1 1 1 1 1 1 1 1 1 1 1 1 1 1 1 1 1 1
1 1 1 1 5 1 1 1 1 1 6 1 1 1 1 1 1 1 1 1 1 1 -1 1 1 1 1 1 1 1 1
1 1 1 1 1 1 1 1 1 6 1 1 1 1 1 1 1 5 1 1 1 1 1 1 1 1 1 1 1 1 1
1 1 1 1 1 1 1 1 1 1 1 1 1 1 1 1 1 1 1 1 1 1 1 1 1 1 5 1 1 1 1
1 1 5 1 1 1 1 1 1 1 1 1 1 1 1 1 1 1 1 1 1 1 1 1 1 1 1 1 1 1 1
1 1 1 1 1 1 1 1 1 1 1 1 1 1 1 1 1 1 1 1 1 1 1 1 1 1 1 1 1 1 1