2 2 2 2 2 2 2 2 2 2 2 2 2 2 2 2
2 1 1 1 1 1 1 1 1 1 1 1 1 1 1 2
2 1 1 8 1 1 1 1 1 1 1 1 1 1 1 2
2 1 1 1 1 1 2 2 2 2 1 1 1 1 1 2
2 1 1 1 2 2 2 1 1 2 2 2 1 1 1 2
2 1 1 1 2 1 1 1 1 1 1 2 1 1 1 2
2 1 1 2 2 1 2 1 1 2 1 2 2 1 1 2
2 1 1 2 1 1 2 1 1 2 1 1 2 1 1 2
2 1 1 2 1 1 2 1 7 2 1 1 2 1 1 2
2 1 1 2 2 1 2 2 2 2 1 2 2 1 1 2
2 1 1 1 2 1 1 1 1 1 1 2 1 1 1 2
2 1 1 1 2 2 2 1 1 2 2 2 1 1 1 2
2 1 1 1 1 1 2 1 1 2 1 1 1 1 1 2
2 1 1 1 1 1 2 1 1 2 1 1 1 1 1 2
2 1 1 1 1 1 2 1 1 2 1 1 1 1 1 2
2 1 1 1 1 1 1 1 1 1 1 1 1 1 1 2
2 2 2 2 2 2 2 2 2 2 2 2 2 2 2 2